tropical = {
	
}

arid = {
	144 145 146 143 464 463 460 138 142 141 140 139 136 132 131 130 458 459 465 462 457 456 461 466 453 452 451 449 455 454 447 446 443 272 448 650 450 649 645 648 646 647 514 515 513 512 510 511 509 499 502 500 503 516 505 504 508 506 507 537 536 534 535 533 531 530 484 483 479 476 477 480 481 478 482 485 467 472 468 469
	473 470 474 471 475 486 487 488 489 490 491 492 493 496 498 494 497 
	439 437 436 432 431 434 430 675 433 438 529 528 526 527 525 517 518 524 519 523 520 521 522
}

arctic = {
	667 668 669 358 799 798 629 800
}

mild_winter = {
	405 404 418 419 327 539 541 543 546 549
}

normal_winter = {
	360 359 361 363 362 364 356 355 354 352 353 660 246 247 251 253 256 259 258 262 261 690 308 299 370 366 300 303 301 619 620 621 622 623 627 626 628 630 625 624 642 420684 683 548 
}

severe_winter = {
	365 358 669 668 667 633 632 631 630 357 629 800 799 798 634 655 
}

impassable = {
	811 812 813 814 815 816 817 818 819 820 821 822 823 824 825 826 827 828 829 830
	831 832 833 834 835 836 837 240 808 810 241 809 838 839 840 841 842 843 844 845 846 847 848 849 850 851 852 853 853 854 855 856 857 858 859 860
}
